856 857 863 861 859 858 832 833 834 835 
0.6049797500341486

856 848 847 846 845 844 843 842 841 840 839 533 838 837 836 835 
0.6146820167275153

862 861 859 858 831 855 869 870 
0.7822822964938757

176 851 852 853 854 855 831 858 859 860 
0.7656242972082228

862 861 863 857 856 849 865 867 869 870 
0.8637010159689265
